000000000000000000000000000000000000000000000000000000000001
111000001111000001111110000011110000011111100000111100000111
100000000000000000001000000000000000000010000000000000000001
100000000000000000001000000000000000000010000000000000000001
100000000000111110001000000000001111100010000000000001110001
111100001111000001111110000011110000011111110000111000000011
100000000000000000001000000000000000000010000000000000000001
100000000000000000001000000000000000000010000000000000000001
100110000000111110001001100000001111100010011000000011111001
111000001111000001111110000011110000011111100000111100000111
100000000000000000001000000000000000000010000000000000000001
100000000000000000001000000000000000000010000000000000000001
100110000000111110001001100000001111100010011000000011111001
100000000000100000001000000000001000000010000000000010000001
100000010000100000001000000100001000000010000001000010000001
111000011111100001111110000111111000011111100001111110000111
100000000000000000001000000000001000000010000000000010000001
100000010000000000001000000000001000000010000000000010000001
111000011111100001111110000111111000011111100001111110000111
100000000000000000000000000000000000000000000000000000000001
100000000000000000000000000000000000000000000000000000000001
111111111111111111111111111111111111111111111111111111111111