00000000000000000000
11100000111100000111
10000000000000000000
10000000000000000000
10011000000011111000
10000000000010000000
10000001000010000000
11100001111110000111
00000000000000000000
00000000000000000000
11111111111111111111