q0000000000000000000000000000000000000000000000000000000000q
q0000000w999999e00000w99999ec000cw99999e00000w99999e0000000q
qx000000000000000000000000000000000000000000000000000000000q
cw999e000000000000000000000000000000000000000000000000w999ec
q00000000000000000000000000000c0000000000000x00000000000000q
q00000000000000000000000000000q0000000000000xx0000000000000q
q00000000000000000000000000000qx00000000000xxx0000000000000q
q00000000000000w999e00000000wecwe00000000w999e0000000000000q
q0000000000000000000000c0000000000000c000000000000000000000q
q0000000000000000000000q0000000000000q000000000000000000000q
q0000000000000000000000q0000000000000q000000000000000000000q
q0000000000000000000000we00000000000we000000000000000000000q
q0000000000000000000000q000000000000xq000000000000000000000q
q000000000000000000000xq00000000000xxq000000000000000000000q
q0000000000000000000w9ecw9e00w9e00w9ecw9e000000000000000000q
q00000000000000000000000000000q0000000000000000000000000000q
q00000000000000000000000000000q0000000000000000000000000000q
cw99999e00000w999999e0000000cw9ec0000000w99999e00000w99999ec
q000000000000000000000000000q000q00000000000000000000000000q
qxxx00000000xx00000000000000q000q000000000000000000000xx000q
q888888888888888888888888888c888c88888888888888888888888888q
q7777777777777777777777777777777777777777777777777777777777q