00000000000000000000
11100000111100000111
00000000000000000000
00000000000000000000
00011111000011111000
00000000000000000000
00000000000000000000
11100000111100000111
00000000000000000000
00000000000000000000
11111111111111111111